1111111111
1100\n0011
10PEC00001
1111111111
