11111111
10001
111111111111
10001
111111111111
10001
111111111111
10001
111111111111
10001
111111111111
10001
111111111111
10001
111111111111
10001
111111111111
10001
111111111111
10001
111111111111
10001
1111
